2 2 2 2 2 2 2 2 2 2 2 2 2 2 2 2 2 2 2 2 2 2 2 2 2
2 0 0 0 3 0 0 0 0 0 0 0 0 0 0 2 2 0 0 8 0 0 11 4 2
2 0 0 2 2 0 0 0 2 0 0 2 2 2 0 2 2 2 0 0 0 10 0 0 2
2 0 0 2 2 2 0 0 2 2 0 0 2 2 0 0 2 2 2 0 0 8 0 0 2
2 0 0 0 2 2 0 0 2 0 0 0 0 2 0 0 0 2 2 2 0 10 4 0 2
2 0 0 0 0 0 0 0 0 0 0 2 0 0 0 0 0 0 2 2 2 13 13 13 2
2 0 0 0 0 2 0 0 0 0 2 2 2 0 0 2 0 0 0 2 2 2 3 13 2
2 0 0 0 2 4 0 0 0 0 0 2 0 0 2 2 2 0 2 2 2 13 0 0 2
2 0 0 2 2 2 0 0 0 0 0 0 0 0 0 2 2 0 0 2 0 0 0 0 2
2 0 0 0 2 0 0 0 0 0 0 0 2 2 0 2 2 2 0 0 0 0 0 0 2
2 0 0 0 0 0 0 0 0 2 0 0 2 2 0 0 2 2 0 0 0 0 0 0 2
2 0 0 0 0 0 0 0 0 2 0 0 0 0 0 0 2 0 0 0 0 0 0 0 2
2 0 0 2 2 2 2 0 0 2 2 0 0 0 0 0 0 0 0 13 0 0 0 0 2
2 0 0 0 12 0 0 0 2 2 2 2 0 0 0 0 0 0 0 0 0 0 0 12 2
2 2 2 2 2 2 2 2 2 2 2 2 2 2 2 2 2 2 2 2 2 2 2 2 2