2 2 2 2 2 2 2 2 2 2 2 2 2 2 2 2 2 2 2 2 2 2 2 2 2 2 2 2 2 2 2
2 0 0 0 3 0 0 0 0 0 0 0 0 0 0 13 13 0 0 8 0 0 0 13 2 0 0 0 13 13 2
2 0 0 2 2 0 0 0 2 0 0 2 2 2 0 2 2 2 0 0 0 10 0 0 13 0 0 0 13 0 2
2 0 0 2 2 2 0 0 2 2 0 0 2 2 0 0 2 2 2 0 0 8 0 0 13 0 0 0 0 0 2
2 0 0 0 2 2 0 0 2 0 0 0 0 2 0 0 0 2 2 2 0 10 0 0 2 0 0 0 8 0 2
2 0 0 0 0 0 0 0 0 0 0 2 0 0 0 0 0 0 2 2 2 13 13 13 2 0 0 0 0 0 2
2 0 0 0 0 2 0 0 0 0 2 2 2 0 0 2 0 0 0 2 2 2 3 13 2 0 0 0 0 0 2
2 0 0 0 2 13 0 0 0 0 0 2 0 0 2 2 2 0 2 2 2 13 0 0 2 0 0 0 0 13 2
2 0 0 2 2 2 0 0 0 0 0 0 0 0 0 2 2 0 0 2 0 0 0 0 2 0 13 2 2 2 2
2 0 0 0 2 0 0 0 0 0 0 0 2 2 0 2 2 2 0 0 0 0 0 0 2 0 2 2 2 2 2
2 0 0 0 0 0 0 0 0 2 0 0 2 2 0 0 2 2 0 0 0 0 0 0 2 0 0 0 0 13 2
2 0 0 0 0 0 0 0 0 2 0 0 0 0 0 0 2 0 0 0 0 0 0 0 2 0 0 0 0 0 2
2 0 0 2 2 2 2 0 0 2 2 0 0 0 0 0 0 0 0 13 0 0 0 0 2 0 0 13 0 0 2
2 0 0 0 12 0 0 0 2 2 2 2 0 0 0 0 0 0 0 0 0 0 0 12 2 0 0 0 4 0 2
2 2 2 2 2 2 2 2 2 2 2 2 2 2 2 2 2 2 2 2 2 2 2 2 2 2 2 2 2 2 2