2 2 2 2 2 2 2 2 2 2 2 2 2 2 2 2 2 2 2 2 2 2 2 2 2
2 0 2 2 2 2 2 2 0 0 0 0 0 0 0 0 4 2 2 2 2 2 2 2 2
2 0 0 2 2 2 2 0 0 0 10 2 2 2 2 2 2 2 2 2 2 2 2 2 2
2 2 0 2 2 2 10 0 0 0 0 2 2 2 2 2 2 2 2 2 2 2 2 2 2
2 2 0 2 2 0 0 0 10 0 0 2 2 0 0 0 0 0 0 0 2 2 2 2 2
2 2 0 2 0 0 0 0 0 0 0 1 0 0 0 0 0 0 0 0 0 2 2 2 2
2 2 0 0 0 0 0 0 0 0 0 0 0 0 0 0 0 0 0 0 0 0 2 2 2
2 2 0 0 0 0 0 0 0 0 0 0 0 0 0 0 0 0 0 0 0 0 0 2 2
2 0 0 2 0 0 2 0 0 2 0 0 2 0 0 2 0 0 2 0 0 2 0 0 2
2 0 0 0 0 0 0 0 0 0 0 0 0 0 0 0 0 0 0 0 0 0 0 0 2
2 2 0 0 2 2 0 0 2 2 0 0 2 2 0 0 2 2 0 0 2 2 0 0 2
2 0 0 0 0 0 0 0 0 0 0 0 0 0 0 0 0 0 0 0 0 0 0 0 2
2 0 2 7 2 0 2 0 2 0 2 0 2 0 2 0 2 0 2 0 2 0 2 0 2
2 0 0 0 3 0 0 0 0 0 0 12 0 0 0 0 0 0 0 0 0 0 0 12 2
2 2 2 2 2 2 2 2 2 2 2 2 2 2 2 2 2 2 2 2 2 2 2 2 2