2222222222222222222222222
2020202020202020202022022
2000000002222000000000002
2202222222222220000000002
2202222222222220000000002
2202222222222220000000002
2202222222222220000000002
2202222222222220000000002
2202222222222220000000002
2202222222222220000000002
2202222222222220000000002
2202222222222220000000002
2202222222222220000000002
2202222222222220000000002
2222222222222222222222222