2 2 2 2 2 2 2 2 2 2 2 2 2 2 2 2 2 2 2 2 2 2 2 2 2 2 2 2 2 2 2 2 2 2 2 2 2
2 0 3 0 0 0 0 0 0 3 0 0 0 0 0 0 0 0 0 0 0 0 0 0 2 0 0 0 0 2 0 0 0 0 0 0 2
2 0 0 0 0 5 2 3 2 0 2 0 2 0 2 0 2 0 2 0 2 0 2 0 2 0 0 0 0 2 0 0 0 2 2 2 2
2 0 0 0 0 3 0 0 0 0 7 0 0 0 0 0 0 0 0 0 0 0 0 0 2 0 0 0 0 2 0 0 0 2 0 0 2
2 0 2 0 2 6 2 0 3 0 2 0 2 0 2 0 2 0 2 0 2 0 2 0 2 0 0 0 0 2 0 0 0 2 0 0 2
2 0 0 0 0 2 0 0 0 2 0 0 0 0 0 2 0 0 0 0 0 0 0 0 2 0 0 0 0 2 0 0 0 2 0 0 2
2 0 3 2 2 0 2 0 2 0 2 0 2 0 2 1 2 0 2 0 2 0 2 0 2 1 0 0 0 2 0 0 0 2 0 0 2
2 0 0 0 0 0 0 0 0 0 0 0 0 4 0 0 0 0 0 0 0 0 0 0 2 0 0 0 0 2 0 0 0 2 0 0 2
2 0 2 0 2 0 2 0 2 0 2 0 2 0 2 0 2 0 2 0 2 0 2 0 2 0 0 0 0 2 0 0 0 2 0 0 2
2 0 0 0 0 0 0 0 0 0 0 0 0 0 0 0 0 0 0 0 0 0 0 0 2 0 0 0 0 2 0 0 0 2 0 0 2
2 0 2 0 2 0 2 0 2 0 2 0 2 0 2 0 2 0 2 0 2 0 2 0 2 1 0 0 0 2 0 0 0 2 0 0 2
2 0 0 0 0 0 0 0 0 0 0 0 0 0 0 0 0 0 0 0 0 0 0 1 2 0 0 0 0 2 0 0 0 2 0 0 2
2 0 2 1 2 0 2 0 2 0 2 1 2 0 2 0 1 0 2 0 2 0 2 0 2 0 0 0 0 2 0 0 0 2 0 0 2
2 0 0 0 0 0 0 1 0 1 0 0 0 0 0 0 0 0 0 0 0 0 0 0 2 0 0 0 0 2 0 0 0 2 0 0 2
2 2 2 2 2 2 2 2 2 2 2 2 2 2 2 2 2 2 2 2 2 2 2 2 2 0 0 0 0 2 0 0 0 2 0 0 2