2 2 2 2 2 2 2 2 2 2 2 2 2 2 2 2 2 2 2 2 2 2 2 2 2 2 2 2 2 2 2
2 0 0 0 2 0 0 0 2 2 2 2 2 0 0 0 2 2 2 0 0 0 0 13 0 2 0 13 0 0 2
2 0 0 2 2 2 0 0 0 2 2 2 0 0 0 0 0 2 0 0 0 0 0 0 0 13 2 0 4 0 2
2 0 2 0 0 0 2 0 0 0 2 13 0 0 0 0 13 2 0 9 0 0 0 0 0 13 2 0 13 0 2
2 0 2 0 0 0 2 0 0 0 0 0 0 0 0 0 0 2 0 0 0 0 0 0 0 0 0 2 0 0 2
2 0 2 0 0 0 2 0 0 0 0 0 0 0 0 0 0 5 0 0 0 0 0 2 0 0 0 13 0 0 2
2 0 0 2 2 2 0 0 0 0 2 0 0 0 0 0 0 2 2 2 2 2 2 2 0 0 0 0 0 0 2
2 0 0 0 2 0 0 0 0 2 2 2 0 0 0 0 0 2 2 2 2 2 2 2 0 0 0 0 0 0 2
2 0 0 3 2 5 0 0 2 2 2 2 2 0 0 0 2 2 2 2 2 2 2 2 0 0 0 0 0 0 2
2 0 2 0 0 0 2 0 0 2 2 2 0 0 0 2 2 2 2 2 0 0 2 2 0 0 0 0 13 0 2
2 0 2 0 0 0 2 0 0 0 2 0 0 0 2 2 2 2 2 0 0 0 2 2 0 0 0 0 0 0 2
2 0 2 8 0 0 2 0 0 0 0 0 0 0 0 2 2 2 0 0 0 8 0 2 0 2 2 13 13 2 2
2 0 0 2 13 2 0 0 0 0 0 0 0 0 0 0 2 0 0 11 0 0 0 2 0 0 0 0 0 0 2
2 0 0 0 1 0 0 0 0 0 0 0 0 0 0 0 13 0 0 0 0 0 0 13 0 0 0 0 8 0 2
2 2 2 2 2 2 2 2 2 2 2 2 2 2 2 2 2 2 2 2 2 2 2 2 2 2 2 2 2 2 2