2 2 2 2 2 2 2 2 2 2 2 2 2 2 2 2 2 2 2 2 2 2 2 2 2 
2 0 0 0 2 0 0 0 2 2 2 2 2 0 0 0 2 2 2 0 0 10 0 4 2 
2 0 0 2 2 2 0 0 0 2 2 2 0 0 0 0 0 2 0 0 0 0 0 0 2 
2 0 2 0 0 0 2 0 0 0 2 0 0 0 0 0 0 2 0 9 0 0 0 0 2
2 0 2 0 0 0 2 0 0 0 0 0 0 0 0 0 0 2 0 0 0 0 0 0 2 
2 0 2 0 0 0 2 0 0 0 0 0 0 0 0 0 0 5 0 0 0 0 0 2 2 
2 0 0 2 2 2 0 0 0 0 2 0 0 0 0 0 0 2 2 2 2 2 2 2 2 
2 0 0 0 2 0 0 0 0 2 2 2 0 0 0 0 0 2 2 2 2 2 2 2 2 
2 0 0 3 2 5 0 0 2 2 2 2 2 0 0 0 2 2 2 2 2 2 2 2 2 
2 0 2 0 0 0 2 0 0 2 2 2 0 0 0 2 2 2 2 2 0 0 2 2 2 
2 0 2 0 0 0 2 0 0 0 2 0 0 0 2 2 2 2 2 0 0 0 2 2 2 
2 0 2 8 0 0 2 0 0 0 0 0 0 0 0 2 2 2 0 0 0 8 0 2 2 
2 0 0 2 6 2 0 0 0 0 0 0 0 0 0 0 2 0 0 0 0 0 0 0 2 
2 0 0 0 1 0 0 0 0 0 0 0 0 0 0 0 0 0 0 0 0 0 0 0 2 
2 2 2 2 2 2 2 2 2 2 2 2 2 2 2 2 2 2 2 2 2 2 2 2 2 